WWWWWWWWWWWWWWWWWWWWWWWWWWWW
WPPPPPPPPPPPPPPPPPPPPPPPPPPW
WPWWPWWWWPWWWWWWWWPWWWWPWWPW
WPWWPWWWWPWWWWWWWWPWWWWPWWPW
WPWW$PPPPPPPPWWPPPPPPPP$WWPW
WPWWWWWWWPWWPWWPWWPWWWWWWWPW
WPWWWWWWWPWWPWWPWWPWWWWWWWPW
 PPPPPPPPPWWPWWPWWPPPPPPPPP 
WPWWWWPWWPWWPPPPWWPWWPWWWWPW
WPWWWWPWWPWWWWWWWWPWWPWWWWPW
WPWWPPPWWPWWWWWWWWPWWPPPWWPW
WPWWPWWWW          WWWWPWWPW
WPWWPWWWW WWBBBBWW WWWWPWWPW
WPPPPPPWW W   1  W WWPPPPPPW
WPWWWWPWW W 2  3 W WWPWWWWPW
WPWWWWPWW W  4   W WWPWWWWPW
WPPPWWPWW WWWWWWWW WWPWWPPPW
WWWPWWPPP          PPPWWPWWW
WWWPWWPWWPWWWWWWWWPWWPWWPWWW
WWWPPPPWWPWWWWWWWWPWWPPPPWWW
WWWPWWWWWPPPPWWPPPPWWWWWPWWW
WWWPWWWWWPWWPWWPWWPWWWWWPWWW
 PPPPPPWWPWWPWWPWWPWWPPPPPP 
WWWPWWPWWPWWPPPPWWPWWPWWPWWW
WWWPWWPWWPWWWWWWWWPWWPWWPWWW
WWWPWWPWWPWWWWWWWWPWWPWWPWWW
WPP$WWPPPPPPPPPP@PPPPPWW$PPW
WPWWWWPWWWWWPWWPWWWWWPWWWWPW
WPWWWWPWWWWWPWWPWWWWWPWWWWPW
WPPPPPPPPPPPPWWPPPPPPPPPPPPW
WWWWWWWWWWWWWWWWWWWWWWWWWWWW